0000000011000111
0110111011011111
0110111000011100
0111111110011101
0000000111111101
1011010100010000
1011000101101101
1011111101101101
1111110001111001
1000011101000111
1011011101110111
0011000001111111
1011111101110111
1000001100110000
1011011100110110
1011000000000110